111111111111111111111111
1C0000000000000C00001E11
101001010010000010C11011
101001001010101000100001
1P0000000C00C00000000101
111111111111111111111111