1111111111111111111111
1000000000000000000001
1C11C0C111C11111C10001
11111011C111C0C1110101
101C001000000000000101
101110101111111110C101
100C10100P1E0000101101
1011101011111010101C01
101C001010001C10101001
10111C101C1011101C1001
100C111011100000111001
100000000C100000000001
1111111111111111111111